############_#
#_________#__#
#_##_#######_#
#_##_________#
#_############
