##########_###
#_____#______#
#_##_###_#####
#_##_____#####
#_############