######################################################_#
#______________________________________________________#
#_###########################_########################_#
#_##__#######################_########################_#
#_###########################_########################_#
#_###########################_########################_#
#______________________________________________________#
#_###########################_########################_#
#_##__#######################__#######################_#
#_###########################__########################_#
#_###########################_########################_#
#______________________________________________________#
#_######################################################
#_##__##################################################
#_######################################################
#_####################################################_#
#______________________________________________________#
#_######################################################
#_##__##################################################
#_######################################################