######################################################_#
#______________________________________________________#
#_######################################################
#_##__##################################################
#_######################################################
#_######################################################